R 1920 1080
NO ./eagle.xpm
SO ./eagle.xpm
WE ./eagle.xpm
EA ./eagle.xpm

S ./eagle.xpm
F 120,255,255
C 255,155,100

       1 1      111           111         111
       111     11111         10001       10001
       111    1111111       1000001     1000001   
1111111111   111111111     100000001   100000001   1
       111  11111111111   10000000001111000000011111
       11111111111111111 100000000000000000000000001
       111111111111111111001111000000000000000000001
       111111111111111111101  1000000000000000011111
       111111111111111111101  10000000000000001
111111111111111111111111101    1000000000000001
    1111111111111111111101      10000000000000111111
   1111111111111111100001        1000000000000000001
  11111111111111111100001        1000000000000111111
 111111111111111111100001        10000000000001
1111111111111111111100011111111111000000000000011
 11111111111111111110001         10000000000000001
  1111111111111111110001         100000000000000001
      111111111111100001         100000000N00000001
      1111111111111000001       10000000000000000011
11111111111111111110000001     1000000000000000001
   111111111111111100000001   1000000000000000001
1111111111111111111000000001 1000000000000000001
    111111111111  1000000001 100000000000111111
      1111111111  1000000001 100000000000111
1111111111111111  1000000001 10000000000011111111111
1111111111111111  1000000001110000000000000000000001
1000000000000001111000000000000000000000000000000001
1111111111111111000001111111111111111111111111111111
       111    1000001         111         111
       111     10001         11111       11111
       111    1000001       1111111     1111111  
1111111111   100000001     111111111   111111111   1
       111  11111111111   11111111111111111111111111
                          11111111111111111111111111
                          11111111111111111111111111